1 1 1 1 1 1 1
1 0 0 0 1 1 1
1 0 1 0 1 1 1
1 0 1 0 0 1 1
0 0 1 1 0 0 1
0 1 1 1 1 3 1
2 1 1 1 1 1 1

#1 wall
#0 open
#2 enter
#3 exit
